0000000000000
1101211101110
0002010101010
0111110100010
0101000100010
0111111100010
0002000100000
0001011101110
0002010101010
0111211111010
0100010001010
0111211111110
0000000000000